#######
#      
# # #  
# #E#  
# ### #
#S  #  
#######