#######
# #    
# # ## 
# #E#  
# ### #
#S     
#######